111111111111111
100000000000001
100000000111001
100011110000001
100000000000001
100000000001001
100000111111001
100000000000001
111111111111111